"filename", "language", "vue", "JavaScript", "XML", "comment", "blank", "total"
"/home/dell/local/vue_video_pj/src/App.vue", "vue", 24, 0, 0, 0, 2, 26
"/home/dell/local/vue_video_pj/src/assets/logo.svg", "XML", 0, 0, 1, 0, 1, 2
"/home/dell/local/vue_video_pj/src/components/HelloWorld.vue", "vue", 141, 0, 0, 0, 11, 152
"/home/dell/local/vue_video_pj/src/components/NavBar.vue", "vue", 834, 0, 0, 34, 34, 902
"/home/dell/local/vue_video_pj/src/components/PlaylistCard.vue", "vue", 127, 0, 0, 0, 11, 138
"/home/dell/local/vue_video_pj/src/components/RecommendVideoCard.vue", "vue", 67, 0, 0, 2, 3, 72
"/home/dell/local/vue_video_pj/src/components/SavedPlaylistModal.vue", "vue", 320, 0, 0, 0, 12, 332
"/home/dell/local/vue_video_pj/src/components/SettingsModal.vue", "vue", 372, 0, 0, 0, 24, 396
"/home/dell/local/vue_video_pj/src/components/SigninModal.vue", "vue", 41, 0, 0, 0, 4, 45
"/home/dell/local/vue_video_pj/src/components/Singers/ReplyCommentModal.vue", "vue", 168, 0, 0, 0, 5, 173
"/home/dell/local/vue_video_pj/src/components/Singers/SingerSettingsModal.vue", "vue", 373, 0, 0, 0, 24, 397
"/home/dell/local/vue_video_pj/src/components/Singers/StudioNavBar.vue", "vue", 529, 0, 0, 12, 27, 568
"/home/dell/local/vue_video_pj/src/components/StudioNavBar.vue", "vue", 390, 0, 0, 12, 23, 425
"/home/dell/local/vue_video_pj/src/components/SubscribersModal.vue", "vue", 124, 0, 0, 10, 7, 141
"/home/dell/local/vue_video_pj/src/components/UploadVideoModal.vue", "vue", 465, 0, 0, 0, 17, 482
"/home/dell/local/vue_video_pj/src/components/VideoCard.vue", "vue", 198, 0, 0, 0, 9, 207
"/home/dell/local/vue_video_pj/src/components/charts/BarChart.vue", "vue", 76, 0, 0, 0, 4, 80
"/home/dell/local/vue_video_pj/src/components/charts/LineChart.vue", "vue", 94, 0, 0, 0, 4, 98
"/home/dell/local/vue_video_pj/src/components/charts/PieChart.vue", "vue", 67, 0, 0, 0, 4, 71
"/home/dell/local/vue_video_pj/src/components/comments/AddComment.vue", "vue", 105, 0, 0, 0, 6, 111
"/home/dell/local/vue_video_pj/src/components/comments/CommentList.vue", "vue", 418, 0, 0, 1, 16, 435
"/home/dell/local/vue_video_pj/src/components/parts/DateTimePicker.vue", "vue", 95, 0, 0, 0, 1, 96
"/home/dell/local/vue_video_pj/src/layouts/DefaultLayout.vue", "vue", 20, 0, 0, 0, 3, 23
"/home/dell/local/vue_video_pj/src/main.js", "JavaScript", 0, 63, 0, 11, 13, 87
"/home/dell/local/vue_video_pj/src/plugins/vuetify.js", "JavaScript", 0, 5, 0, 0, 3, 8
"/home/dell/local/vue_video_pj/src/router/index.js", "JavaScript", 0, 155, 0, 5, 5, 165
"/home/dell/local/vue_video_pj/src/services/Api.js", "JavaScript", 0, 22, 0, 0, 5, 27
"/home/dell/local/vue_video_pj/src/services/AuthenticationService.js", "JavaScript", 0, 26, 0, 0, 2, 28
"/home/dell/local/vue_video_pj/src/services/CategoryService.js", "JavaScript", 0, 6, 0, 0, 2, 8
"/home/dell/local/vue_video_pj/src/services/CommentService.js", "JavaScript", 0, 21, 0, 0, 2, 23
"/home/dell/local/vue_video_pj/src/services/FeelingService.js", "JavaScript", 0, 12, 0, 0, 2, 14
"/home/dell/local/vue_video_pj/src/services/HashTagService.js", "JavaScript", 0, 6, 0, 0, 2, 8
"/home/dell/local/vue_video_pj/src/services/HistoryService.js", "JavaScript", 0, 18, 0, 0, 2, 20
"/home/dell/local/vue_video_pj/src/services/NotificationService.js", "JavaScript", 0, 19, 0, 0, 2, 21
"/home/dell/local/vue_video_pj/src/services/OwnPlaylistService.js", "JavaScript", 0, 24, 0, 0, 2, 26
"/home/dell/local/vue_video_pj/src/services/PlaylistService.js", "JavaScript", 0, 15, 0, 0, 2, 17
"/home/dell/local/vue_video_pj/src/services/ReplyService.js", "JavaScript", 0, 12, 0, 0, 2, 14
"/home/dell/local/vue_video_pj/src/services/SearchService.js", "JavaScript", 0, 6, 0, 0, 2, 8
"/home/dell/local/vue_video_pj/src/services/SingerService.js", "JavaScript", 0, 24, 0, 0, 2, 26
"/home/dell/local/vue_video_pj/src/services/SubscriptionService.js", "JavaScript", 0, 30, 0, 0, 2, 32
"/home/dell/local/vue_video_pj/src/services/VideoService.js", "JavaScript", 0, 61, 0, 0, 2, 63
"/home/dell/local/vue_video_pj/src/services/WatchLaterService.js", "JavaScript", 0, 15, 0, 0, 2, 17
"/home/dell/local/vue_video_pj/src/store/index.js", "JavaScript", 0, 22, 0, 45, 3, 70
"/home/dell/local/vue_video_pj/src/store/modules/auth.js", "JavaScript", 0, 161, 0, 0, 4, 165
"/home/dell/local/vue_video_pj/src/store/modules/comment.js", "JavaScript", 0, 37, 0, 2, 3, 42
"/home/dell/local/vue_video_pj/src/store/modules/ownplaylist.js", "JavaScript", 0, 47, 0, 0, 3, 50
"/home/dell/local/vue_video_pj/src/store/modules/singerauth.js", "JavaScript", 0, 155, 0, 0, 4, 159
"/home/dell/local/vue_video_pj/src/views/AboutView.vue", "vue", 33, 0, 0, 2, 6, 41
"/home/dell/local/vue_video_pj/src/views/Auth/SignIn.vue", "vue", 124, 0, 0, 0, 5, 129
"/home/dell/local/vue_video_pj/src/views/Auth/SignUp.vue", "vue", 309, 0, 0, 0, 7, 316
"/home/dell/local/vue_video_pj/src/views/Auth/SingerSignIn.vue", "vue", 130, 0, 0, 0, 5, 135
"/home/dell/local/vue_video_pj/src/views/Auth/SingerSignUp.vue", "vue", 313, 0, 0, 0, 12, 325
"/home/dell/local/vue_video_pj/src/views/Channel/ChannelHome.vue", "vue", 318, 0, 0, 3, 19, 340
"/home/dell/local/vue_video_pj/src/views/DashBoard.vue", "vue", 61, 0, 0, 0, 4, 65
"/home/dell/local/vue_video_pj/src/views/HistoryVideo.vue", "vue", 378, 0, 0, 8, 12, 398
"/home/dell/local/vue_video_pj/src/views/HomeView.vue", "vue", 468, 0, 0, 0, 7, 475
"/home/dell/local/vue_video_pj/src/views/LikedVideo.vue", "vue", 168, 0, 0, 1, 9, 178
"/home/dell/local/vue_video_pj/src/views/OwnPlaylistVideo.vue", "vue", 408, 0, 0, 0, 8, 416
"/home/dell/local/vue_video_pj/src/views/SearchVideo.vue", "vue", 266, 0, 0, 12, 15, 293
"/home/dell/local/vue_video_pj/src/views/Singer/CommentView.vue", "vue", 248, 0, 0, 4, 12, 264
"/home/dell/local/vue_video_pj/src/views/Singer/DashBoard.vue", "vue", 231, 0, 0, 0, 6, 237
"/home/dell/local/vue_video_pj/src/views/Singer/DetailsVideo.vue", "vue", 332, 0, 0, 1, 13, 346
"/home/dell/local/vue_video_pj/src/views/Singer/Index.vue", "vue", 10, 0, 0, 0, 2, 12
"/home/dell/local/vue_video_pj/src/views/Singer/SubscriberDashBoard.vue", "vue", 147, 0, 0, 0, 3, 150
"/home/dell/local/vue_video_pj/src/views/Singer/UploadVideo.vue", "vue", 16, 0, 0, 0, 1, 17
"/home/dell/local/vue_video_pj/src/views/Singer/VideoDashBoard.vue", "vue", 182, 0, 0, 0, 2, 184
"/home/dell/local/vue_video_pj/src/views/Singer/VideoView.vue", "vue", 233, 0, 0, 4, 12, 249
"/home/dell/local/vue_video_pj/src/views/Singer/WatchedHourDashBoard.vue", "vue", 124, 0, 0, 0, 5, 129
"/home/dell/local/vue_video_pj/src/views/SubscribedVideo.vue", "vue", 134, 0, 0, 0, 7, 141
"/home/dell/local/vue_video_pj/src/views/TrendingVideo.vue", "vue", 165, 0, 0, 2, 9, 176
"/home/dell/local/vue_video_pj/src/views/WatchLaterVideo.vue", "vue", 356, 0, 0, 0, 12, 368
"/home/dell/local/vue_video_pj/src/views/WatchVideo.vue", "vue", 1195, 0, 0, 29, 48, 1272
"Total", "-", 11397, 962, 1, 200, 566, 13126